---------------------------------
|#|#|#|#|#|#|#|#|#|#|#|#|#|#|#|#|
|#|#|#|#|#|#|#|#|#|#|#|#|#|#|#|#|
|#|#|#|#|#|#|#|#|#|#|#|#|#|#|#|#|
|#|#|#|#|#|#|#|#|#|#|#|#|#|#|#|#|
|#|#|#|#|#|#|#|#|#|#|#|#|#|#|#|#|
|#|#|#|#|#|#|#|#|#|#|#|#|#|#|#|#|
|#|#|#|#|#|#|#|#|#|#|#|#|#|#|#|#|
|#|#|#|#|#|#|#|#|#|#|#|#|#|#|#|#|
|#|#|#|#|#|#|#|#|#|#|#|#|#|#|#|#|
|#|#|#|#|#|#|#|#|#|#|#|#|#|#|#|#|
|#|#|#|#|#|#|#|#|#|#|#|#|#|#|#|#|
|#|#|#|#|#|#|#|#|#|#|#|#|#|#|#|#|
|#|#|#|#|#|#|#|#|#|#|#|#|#|#|#|#|
|#|#|#|#|#|#|#|#|#|#|#|#|#|#|#|#|
|#|#|#|#|#|#|#|#|#|#|#|#|#|#|#|#|
|#|#|#|#|#|#|#|#|#|#|#|#|#|#|#|#|
---------------------------------

12 4
step: 1
---------------------------------
|#|#|#|#|#|#|#|#|#|#|#|#|#|#|#|#|
|#|#|#|#|#|#|#|#|#|#|#|#|#|#|#|#|
|#|#|#|#|#|#|#|#|#|#|#|#|#|#|#|#|
|#|#|#|#|#|#|#|#|#|#|#|#|#|#|#|#|
|#|#|#|#|#|#|#|#|#|#|#|#|#|#|#|#|
|#|#|#|#|#|#|#|#|#|#|#|#|#|#|#|#|
|#|#|#|#|#|#|#|#|#|#|#|#|#|#|#|#|
|#|#|#|#|#|#|#|#|#|#|#|#|#|#|#|#|
|#|#|#|#|#|#|#|#|#|#|#|#|#|#|#|#|
|#|#|#|#|#|#|#|#|#|#|#|#|#|#|#|#|
|#|#|#|#|#|#|#|#|#|#|#|#|#|#|#|#|
|#|#|#|#|#|#|#|#|#|#|#|#|#|#|#|#|
|#|#|#|#|3|#|#|#|#|#|#|#|#|#|#|#|
|#|#|#|#|#|#|#|#|#|#|#|#|#|#|#|#|
|#|#|#|#|#|#|#|#|#|#|#|#|#|#|#|#|
|#|#|#|#|#|#|#|#|#|#|#|#|#|#|#|#|
---------------------------------

13 0
step: 2
---------------------------------
|#|#|#|#|#|#|#|#|#|#|#|#|#|#|#|#|
|#|#|#|#|#|#|#|#|#|#|#|#|#|#|#|#|
|#|#|#|#|#|#|#|#|#|#|#|#|#|#|#|#|
|#|#|#|#|#|#|#|#|#|#|#|#|#|#|#|#|
|#|#|#|#|#|#|#|#|#|#|#|#|#|#|#|#|
|#|#|#|#|#|#|#|#|#|#|#|#|#|#|#|#|
|#|#|#|#|#|#|#|#|#|#|#|#|#|#|#|#|
|#|#|#|#|#|#|#|#|#|#|#|#|#|#|#|#|
|#|#|#|#|#|#|#|#|#|#|#|#|#|#|#|#|
|#|#|#|#|#|#|#|#|#|#|#|#|#|#|#|#|
|#|#|#|#|#|#|#|#|#|#|#|#|#|#|#|#|
|#|#|#|#|#|#|#|#|#|#|#|#|#|#|#|#|
|#|#|#|#|3|#|#|#|#|#|#|#|#|#|#|#|
|2|#|#|#|#|#|#|#|#|#|#|#|#|#|#|#|
|#|#|#|#|#|#|#|#|#|#|#|#|#|#|#|#|
|#|#|#|#|#|#|#|#|#|#|#|#|#|#|#|#|
---------------------------------

1 15
step: 3
---------------------------------
|#|#|#|#|#|#|#|#|#|#|#|#|2| | | |
|#|#|#|#|#|#|#|#|#|#|#|#|2| | | |
|#|#|#|#|#|#|#|#|#|#|#|#|2|1|1| |
|#|#|#|#|#|#|#|#|#|#|#|#|#|#|1| |
|#|#|#|#|#|#|#|#|#|#|2|1|1|1|1| |
|#|#|#|#|#|#|#|#|#|#|2| | | | | |
|#|#|#|#|#|#|#|#|#|#|2|1|1|1| | |
|#|#|#|#|#|#|#|#|#|#|#|#|#|1|1|1|
|#|#|#|#|#|#|#|#|#|#|#|#|#|#|#|#|
|#|#|#|#|#|#|#|#|#|#|#|#|#|#|#|#|
|#|#|#|#|#|#|#|#|#|#|#|#|#|#|#|#|
|#|#|#|#|#|#|#|#|#|#|#|#|#|#|#|#|
|#|#|#|#|3|#|#|#|#|#|#|#|#|#|#|#|
|2|#|#|#|#|#|#|#|#|#|#|#|#|#|#|#|
|#|#|#|#|#|#|#|#|#|#|#|#|#|#|#|#|
|#|#|#|#|#|#|#|#|#|#|#|#|#|#|#|#|
---------------------------------

3 5
step: 4
---------------------------------
|#|#|#|#|#|#|#|#|#|#|#|#|2| | | |
|#|#|#|#|#|#|#|#|#|#|#|#|2| | | |
|#|#|#|#|#|#|#|#|#|#|#|#|2|1|1| |
|#|#|#|#|#|1|#|#|#|#|#|#|#|#|1| |
|#|#|#|#|#|#|#|#|#|#|2|1|1|1|1| |
|#|#|#|#|#|#|#|#|#|#|2| | | | | |
|#|#|#|#|#|#|#|#|#|#|2|1|1|1| | |
|#|#|#|#|#|#|#|#|#|#|#|#|#|1|1|1|
|#|#|#|#|#|#|#|#|#|#|#|#|#|#|#|#|
|#|#|#|#|#|#|#|#|#|#|#|#|#|#|#|#|
|#|#|#|#|#|#|#|#|#|#|#|#|#|#|#|#|
|#|#|#|#|#|#|#|#|#|#|#|#|#|#|#|#|
|#|#|#|#|3|#|#|#|#|#|#|#|#|#|#|#|
|2|#|#|#|#|#|#|#|#|#|#|#|#|#|#|#|
|#|#|#|#|#|#|#|#|#|#|#|#|#|#|#|#|
|#|#|#|#|#|#|#|#|#|#|#|#|#|#|#|#|
---------------------------------

15 4
step: 5
---------------------------------
|#|#|#|#|#|#|#|#|#|#|#|#|2| | | |
|#|#|#|#|#|#|#|#|#|#|#|#|2| | | |
|#|#|#|#|#|#|#|#|#|#|#|#|2|1|1| |
|#|#|#|#|#|1|#|#|#|#|#|#|#|#|1| |
|#|#|#|#|#|#|#|#|#|#|2|1|1|1|1| |
|#|#|#|#|#|#|#|#|#|#|2| | | | | |
|#|#|#|#|#|#|#|#|#|#|2|1|1|1| | |
|#|#|#|#|#|#|#|#|#|#|#|#|#|1|1|1|
|#|#|#|#|#|#|#|#|#|#|#|#|#|#|#|#|
|#|#|#|#|#|#|#|#|#|#|#|#|#|#|#|#|
|#|#|#|#|#|#|#|#|#|#|#|#|#|#|#|#|
|#|#|#|#|#|#|#|#|#|#|#|#|#|#|#|#|
|#|#|#|#|3|#|#|#|#|#|#|#|#|#|#|#|
|2|#|#|#|#|#|#|#|#|#|#|#|#|#|#|#|
|#|#|#|#|#|#|#|#|#|#|#|#|#|#|#|#|
|#|#|#|#|1|#|#|#|#|#|#|#|#|#|#|#|
---------------------------------

1 11
step: 6
---------------------------------
|#|#|#|#|#|#|#|#|#|#|#|#|2| | | |
|#|#|#|#|#|#|#|#|#|#|#|@|2| | | |
|#|#|#|#|#|#|#|#|#|#|#|#|2|1|1| |
|#|#|#|#|#|1|#|#|#|#|#|#|#|#|1| |
|#|#|#|#|#|#|#|#|#|#|2|1|1|1|1| |
|#|#|#|#|#|#|#|#|#|#|2| | | | | |
|#|#|#|#|#|#|#|#|#|#|2|1|1|1| | |
|#|#|#|#|#|#|#|#|#|#|#|#|#|1|1|1|
|#|#|#|#|#|#|#|#|#|#|#|#|#|#|#|#|
|#|#|#|#|#|#|#|#|#|#|#|#|#|#|#|#|
|#|#|#|#|#|#|#|#|#|#|#|#|#|#|#|#|
|#|#|#|#|#|#|#|#|#|#|#|#|#|#|#|#|
|#|#|#|#|3|#|#|#|#|#|#|#|#|#|#|#|
|2|#|#|#|#|#|#|#|#|#|#|#|#|#|#|#|
|#|#|#|#|#|#|#|#|#|#|#|#|#|#|#|#|
|#|#|#|#|1|#|#|#|#|#|#|#|#|#|#|#|
---------------------------------

Gameover :(
請按任意鍵繼續 . . . 