---------------------------------
|#|#|#|#|#|#|#|#|#|#|#|#|#|#|#|#|
|#|#|#|#|#|#|#|#|#|#|#|#|#|#|#|#|
|#|#|#|#|#|#|#|#|#|#|#|#|#|#|#|#|
|#|#|#|#|#|#|#|#|#|#|#|#|#|#|#|#|
|#|#|#|#|#|#|#|#|#|#|#|#|#|#|#|#|
|#|#|#|#|#|#|#|#|#|#|#|#|#|#|#|#|
|#|#|#|#|#|#|#|#|#|#|#|#|#|#|#|#|
|#|#|#|#|#|#|#|#|#|#|#|#|#|#|#|#|
|#|#|#|#|#|#|#|#|#|#|#|#|#|#|#|#|
|#|#|#|#|#|#|#|#|#|#|#|#|#|#|#|#|
|#|#|#|#|#|#|#|#|#|#|#|#|#|#|#|#|
|#|#|#|#|#|#|#|#|#|#|#|#|#|#|#|#|
|#|#|#|#|#|#|#|#|#|#|#|#|#|#|#|#|
|#|#|#|#|#|#|#|#|#|#|#|#|#|#|#|#|
|#|#|#|#|#|#|#|#|#|#|#|#|#|#|#|#|
|#|#|#|#|#|#|#|#|#|#|#|#|#|#|#|#|
---------------------------------

act: 4 13
step: 1
---------------------------------
|#|#|#|#|#|#|#|#|#|#|#|#|#|#|#|#|
|#|#|#|#|#|#|#|#|#|#|#|#|#|#|#|#|
|#|#|#|#|#|#|#|#|#|#|#|#|#|#|#|#|
|#|#|#|#|#|#|#|#|#|#|#|#|#|#|#|#|
|#|#|#|#|#|#|#|#|#|#|#|#|#|1|#|#|
|#|#|#|#|#|#|#|#|#|#|#|#|#|#|#|#|
|#|#|#|#|#|#|#|#|#|#|#|#|#|#|#|#|
|#|#|#|#|#|#|#|#|#|#|#|#|#|#|#|#|
|#|#|#|#|#|#|#|#|#|#|#|#|#|#|#|#|
|#|#|#|#|#|#|#|#|#|#|#|#|#|#|#|#|
|#|#|#|#|#|#|#|#|#|#|#|#|#|#|#|#|
|#|#|#|#|#|#|#|#|#|#|#|#|#|#|#|#|
|#|#|#|#|#|#|#|#|#|#|#|#|#|#|#|#|
|#|#|#|#|#|#|#|#|#|#|#|#|#|#|#|#|
|#|#|#|#|#|#|#|#|#|#|#|#|#|#|#|#|
|#|#|#|#|#|#|#|#|#|#|#|#|#|#|#|#|
---------------------------------

act: 1 5
step: 2
---------------------------------
|#|#|#|#|#|#|#|#|#|#|#|#|#|#|#|#|
|#|#|#|#|#|@|#|#|#|#|#|#|#|#|#|#|
|#|#|#|#|#|#|#|#|#|#|#|#|#|#|#|#|
|#|#|#|#|#|#|#|#|#|#|#|#|#|#|#|#|
|#|#|#|#|#|#|#|#|#|#|#|#|#|1|#|#|
|#|#|#|#|#|#|#|#|#|#|#|#|#|#|#|#|
|#|#|#|#|#|#|#|#|#|#|#|#|#|#|#|#|
|#|#|#|#|#|#|#|#|#|#|#|#|#|#|#|#|
|#|#|#|#|#|#|#|#|#|#|#|#|#|#|#|#|
|#|#|#|#|#|#|#|#|#|#|#|#|#|#|#|#|
|#|#|#|#|#|#|#|#|#|#|#|#|#|#|#|#|
|#|#|#|#|#|#|#|#|#|#|#|#|#|#|#|#|
|#|#|#|#|#|#|#|#|#|#|#|#|#|#|#|#|
|#|#|#|#|#|#|#|#|#|#|#|#|#|#|#|#|
|#|#|#|#|#|#|#|#|#|#|#|#|#|#|#|#|
|#|#|#|#|#|#|#|#|#|#|#|#|#|#|#|#|
---------------------------------

Gameover :(
