---------------------------------
|#|#|#|#|#|#|#|#|#|#|#|#|#|#|#|#|
|#|#|#|#|#|#|#|#|#|#|#|#|#|#|#|#|
|#|#|#|#|#|#|#|#|#|#|#|#|#|#|#|#|
|#|#|#|#|#|#|#|#|#|#|#|#|#|#|#|#|
|#|#|#|#|#|#|#|#|#|#|#|#|#|#|#|#|
|#|#|#|#|#|#|#|#|#|#|#|#|#|#|#|#|
|#|#|#|#|#|#|#|#|#|#|#|#|#|#|#|#|
|#|#|#|#|#|#|#|#|#|#|#|#|#|#|#|#|
|#|#|#|#|#|#|#|#|#|#|#|#|#|#|#|#|
|#|#|#|#|#|#|#|#|#|#|#|#|#|#|#|#|
|#|#|#|#|#|#|#|#|#|#|#|#|#|#|#|#|
|#|#|#|#|#|#|#|#|#|#|#|#|#|#|#|#|
|#|#|#|#|#|#|#|#|#|#|#|#|#|#|#|#|
|#|#|#|#|#|#|#|#|#|#|#|#|#|#|#|#|
|#|#|#|#|#|#|#|#|#|#|#|#|#|#|#|#|
|#|#|#|#|#|#|#|#|#|#|#|#|#|#|#|#|
---------------------------------

act: 13 4
step: 1
---------------------------------
|#|#|#|#|#|#|#|#|#|#|#|#|#|#|#|#|
|#|#|#|#|#|#|#|#|#|#|#|#|#|#|#|#|
|#|#|#|#|#|#|#|#|#|#|#|#|#|#|#|#|
|#|#|#|#|#|#|#|#|#|#|#|#|#|#|#|#|
|#|#|#|#|#|#|#|#|#|#|#|#|#|#|#|#|
|#|#|#|#|#|#|#|#|#|#|#|#|#|#|#|#|
|#|#|#|#|#|#|#|#|#|#|#|#|#|#|#|#|
|#|#|#|#|#|#|#|#|#|#|#|#|#|#|#|#|
|#|#|#|#|#|#|#|#|#|#|#|#|#|#|#|#|
|#|#|#|#|#|#|#|#|#|#|#|#|#|#|#|#|
|#|#|#|#|#|#|#|#|#|#|#|#|#|#|#|#|
|#|#|#|#|#|#|#|#|#|#|#|#|#|#|#|#|
|#|#|#|#|#|#|#|#|#|#|#|#|#|#|#|#|
|#|#|#|#|2|#|#|#|#|#|#|#|#|#|#|#|
|#|#|#|#|#|#|#|#|#|#|#|#|#|#|#|#|
|#|#|#|#|#|#|#|#|#|#|#|#|#|#|#|#|
---------------------------------

act: 10 8
step: 2
---------------------------------
|#|#|#|#|#|#|#|#|#|#|#|#|#|#|#|#|
|#|#|#|#|#|#|#|#|#|#|#|#|#|#|#|#|
|#|#|#|#|#|#|#|#|#|#|#|#|#|#|#|#|
|#|#|#|#|#|#|#|#|#|#|#|#|#|#|#|#|
|#|#|#|#|#|#|#|#|#|#|#|#|#|#|#|#|
|#|#|#|#|#|#|#|#|#|#|#|#|#|#|#|#|
|#|#|#|#|#|#|#|#|#|#|#|#|#|#|#|#|
|#|#|#|#|#|#|#|#|#|#|#|#|#|#|#|#|
|#|#|#|#|#|#|#|#|#|#|#|#|#|#|#|#|
|#|#|#|#|#|#|#|#|#|#|#|#|#|#|#|#|
|#|#|#|#|#|#|#|#|2|#|#|#|#|#|#|#|
|#|#|#|#|#|#|#|#|#|#|#|#|#|#|#|#|
|#|#|#|#|#|#|#|#|#|#|#|#|#|#|#|#|
|#|#|#|#|2|#|#|#|#|#|#|#|#|#|#|#|
|#|#|#|#|#|#|#|#|#|#|#|#|#|#|#|#|
|#|#|#|#|#|#|#|#|#|#|#|#|#|#|#|#|
---------------------------------

act: 4 6
step: 3
---------------------------------
|#|#|#|#|#|#|#|#|#|#|#|#|#|#|#|#|
|#|#|#|#|#|#|#|#|#|#|#|#|#|#|#|#|
|#|#|#|#|#|#|#|#|#|#|#|#|#|#|#|#|
|#|#|#|#|#|#|#|#|#|#|#|#|#|#|#|#|
|#|#|#|#|#|#|1|#|#|#|#|#|#|#|#|#|
|#|#|#|#|#|#|#|#|#|#|#|#|#|#|#|#|
|#|#|#|#|#|#|#|#|#|#|#|#|#|#|#|#|
|#|#|#|#|#|#|#|#|#|#|#|#|#|#|#|#|
|#|#|#|#|#|#|#|#|#|#|#|#|#|#|#|#|
|#|#|#|#|#|#|#|#|#|#|#|#|#|#|#|#|
|#|#|#|#|#|#|#|#|2|#|#|#|#|#|#|#|
|#|#|#|#|#|#|#|#|#|#|#|#|#|#|#|#|
|#|#|#|#|#|#|#|#|#|#|#|#|#|#|#|#|
|#|#|#|#|2|#|#|#|#|#|#|#|#|#|#|#|
|#|#|#|#|#|#|#|#|#|#|#|#|#|#|#|#|
|#|#|#|#|#|#|#|#|#|#|#|#|#|#|#|#|
---------------------------------

act: 0 9
step: 4
---------------------------------
|#|#|#|#|#|#|#|#|#|@|#|#|#|#|#|#|
|#|#|#|#|#|#|#|#|#|#|#|#|#|#|#|#|
|#|#|#|#|#|#|#|#|#|#|#|#|#|#|#|#|
|#|#|#|#|#|#|#|#|#|#|#|#|#|#|#|#|
|#|#|#|#|#|#|1|#|#|#|#|#|#|#|#|#|
|#|#|#|#|#|#|#|#|#|#|#|#|#|#|#|#|
|#|#|#|#|#|#|#|#|#|#|#|#|#|#|#|#|
|#|#|#|#|#|#|#|#|#|#|#|#|#|#|#|#|
|#|#|#|#|#|#|#|#|#|#|#|#|#|#|#|#|
|#|#|#|#|#|#|#|#|#|#|#|#|#|#|#|#|
|#|#|#|#|#|#|#|#|2|#|#|#|#|#|#|#|
|#|#|#|#|#|#|#|#|#|#|#|#|#|#|#|#|
|#|#|#|#|#|#|#|#|#|#|#|#|#|#|#|#|
|#|#|#|#|2|#|#|#|#|#|#|#|#|#|#|#|
|#|#|#|#|#|#|#|#|#|#|#|#|#|#|#|#|
|#|#|#|#|#|#|#|#|#|#|#|#|#|#|#|#|
---------------------------------

Gameover :(
