---------------------------------
|#|#|#|#|#|#|#|#|#|#|#|#|#|#|#|#|
|#|#|#|#|#|#|#|#|#|#|#|#|#|#|#|#|
|#|#|#|#|#|#|#|#|#|#|#|#|#|#|#|#|
|#|#|#|#|#|#|#|#|#|#|#|#|#|#|#|#|
|#|#|#|#|#|#|#|#|#|#|#|#|#|#|#|#|
|#|#|#|#|#|#|#|#|#|#|#|#|#|#|#|#|
|#|#|#|#|#|#|#|#|#|#|#|#|#|#|#|#|
|#|#|#|#|#|#|#|#|#|#|#|#|#|#|#|#|
|#|#|#|#|#|#|#|#|#|#|#|#|#|#|#|#|
|#|#|#|#|#|#|#|#|#|#|#|#|#|#|#|#|
|#|#|#|#|#|#|#|#|#|#|#|#|#|#|#|#|
|#|#|#|#|#|#|#|#|#|#|#|#|#|#|#|#|
|#|#|#|#|#|#|#|#|#|#|#|#|#|#|#|#|
|#|#|#|#|#|#|#|#|#|#|#|#|#|#|#|#|
|#|#|#|#|#|#|#|#|#|#|#|#|#|#|#|#|
|#|#|#|#|#|#|#|#|#|#|#|#|#|#|#|#|
---------------------------------

act: 10 1
step: 1
---------------------------------
|#|#|#|#|#|#|#|#|#|#|#|#|#|#|#|#|
|#|#|#|#|#|#|#|#|#|#|#|#|#|#|#|#|
|#|#|#|#|#|#|#|#|#|#|#|#|#|#|#|#|
|#|#|#|#|#|#|#|#|#|#|#|#|#|#|#|#|
|#|#|#|#|#|#|#|#|#|#|#|#|#|#|#|#|
|#|#|#|#|#|#|#|#|#|#|#|#|#|#|#|#|
|#|#|#|#|#|#|#|#|#|#|#|#|#|#|#|#|
|#|#|#|#|#|#|#|#|#|#|#|#|#|#|#|#|
|#|#|#|#|#|#|#|#|#|#|#|#|#|#|#|#|
|#|#|#|#|#|#|#|#|#|#|#|#|#|#|#|#|
|#|1|#|#|#|#|#|#|#|#|#|#|#|#|#|#|
|#|#|#|#|#|#|#|#|#|#|#|#|#|#|#|#|
|#|#|#|#|#|#|#|#|#|#|#|#|#|#|#|#|
|#|#|#|#|#|#|#|#|#|#|#|#|#|#|#|#|
|#|#|#|#|#|#|#|#|#|#|#|#|#|#|#|#|
|#|#|#|#|#|#|#|#|#|#|#|#|#|#|#|#|
---------------------------------

act: 2 7
step: 2
---------------------------------
|#|#|#|#|#|#|#|#|#|#|#|#|#|#|#|#|
|#|#|#|#|#|#|#|#|#|#|#|#|#|#|#|#|
|#|#|#|#|#|#|#|1|#|#|#|#|#|#|#|#|
|#|#|#|#|#|#|#|#|#|#|#|#|#|#|#|#|
|#|#|#|#|#|#|#|#|#|#|#|#|#|#|#|#|
|#|#|#|#|#|#|#|#|#|#|#|#|#|#|#|#|
|#|#|#|#|#|#|#|#|#|#|#|#|#|#|#|#|
|#|#|#|#|#|#|#|#|#|#|#|#|#|#|#|#|
|#|#|#|#|#|#|#|#|#|#|#|#|#|#|#|#|
|#|#|#|#|#|#|#|#|#|#|#|#|#|#|#|#|
|#|1|#|#|#|#|#|#|#|#|#|#|#|#|#|#|
|#|#|#|#|#|#|#|#|#|#|#|#|#|#|#|#|
|#|#|#|#|#|#|#|#|#|#|#|#|#|#|#|#|
|#|#|#|#|#|#|#|#|#|#|#|#|#|#|#|#|
|#|#|#|#|#|#|#|#|#|#|#|#|#|#|#|#|
|#|#|#|#|#|#|#|#|#|#|#|#|#|#|#|#|
---------------------------------

act: 13 13
step: 3
---------------------------------
|#|#|#|#|#|#|#|#|#|#|#|#|#|#|#|#|
|#|#|#|#|#|#|#|#|#|#|#|#|#|#|#|#|
|#|#|#|#|#|#|#|1|#|#|#|#|#|#|#|#|
|#|#|#|#|#|#|#|#|#|#|#|#|#|#|#|#|
|#|#|#|#|#|#|#|#|#|#|#|#|#|#|#|#|
|#|#|#|#|#|#|#|#|#|#|#|#|#|#|#|#|
|#|#|#|#|#|#|#|#|#|#|#|#|#|#|#|#|
|#|#|#|#|#|#|#|#|#|#|#|#|#|#|#|#|
|#|#|#|#|#|#|#|#|#|#|#|#|#|#|#|#|
|#|#|#|#|#|#|#|#|#|#|#|#|#|#|#|#|
|#|1|#|#|#|#|#|#|#|#|#|#|#|#|#|#|
|#|#|#|#|#|#|#|#|#|#|#|#|#|#|#|#|
|#|#|#|#|#|#|#|#|#|#|#|#|#|#|#|#|
|#|#|#|#|#|#|#|#|#|#|#|#|#|@|#|#|
|#|#|#|#|#|#|#|#|#|#|#|#|#|#|#|#|
|#|#|#|#|#|#|#|#|#|#|#|#|#|#|#|#|
---------------------------------

Gameover :(
