---------------------------------
|#|#|#|#|#|#|#|#|#|#|#|#|#|#|#|#|
|#|#|#|#|#|#|#|#|#|#|#|#|#|#|#|#|
|#|#|#|#|#|#|#|#|#|#|#|#|#|#|#|#|
|#|#|#|#|#|#|#|#|#|#|#|#|#|#|#|#|
|#|#|#|#|#|#|#|#|#|#|#|#|#|#|#|#|
|#|#|#|#|#|#|#|#|#|#|#|#|#|#|#|#|
|#|#|#|#|#|#|#|#|#|#|#|#|#|#|#|#|
|#|#|#|#|#|#|#|#|#|#|#|#|#|#|#|#|
|#|#|#|#|#|#|#|#|#|#|#|#|#|#|#|#|
|#|#|#|#|#|#|#|#|#|#|#|#|#|#|#|#|
|#|#|#|#|#|#|#|#|#|#|#|#|#|#|#|#|
|#|#|#|#|#|#|#|#|#|#|#|#|#|#|#|#|
|#|#|#|#|#|#|#|#|#|#|#|#|#|#|#|#|
|#|#|#|#|#|#|#|#|#|#|#|#|#|#|#|#|
|#|#|#|#|#|#|#|#|#|#|#|#|#|#|#|#|
|#|#|#|#|#|#|#|#|#|#|#|#|#|#|#|#|
---------------------------------

act: 6 13
step: 1
---------------------------------
|#|#|#|#|#|#|#|#|#|#|#|#|#|#|#|#|
|#|#|#|#|#|#|#|#|#|#|#|#|#|#|#|#|
|#|#|#|#|#|#|#|#|#|#|#|#|#|#|#|#|
|#|#|#|#|#|#|#|#|#|#|#|#|#|#|#|#|
|#|#|#|#|#|#|#|#|#|#|#|#|#|#|#|#|
|#|#|#|#|#|#|#|#|#|#|#|#|#|#|#|#|
|#|#|#|#|#|#|#|#|#|#|#|#|#|@|#|#|
|#|#|#|#|#|#|#|#|#|#|#|#|#|#|#|#|
|#|#|#|#|#|#|#|#|#|#|#|#|#|#|#|#|
|#|#|#|#|#|#|#|#|#|#|#|#|#|#|#|#|
|#|#|#|#|#|#|#|#|#|#|#|#|#|#|#|#|
|#|#|#|#|#|#|#|#|#|#|#|#|#|#|#|#|
|#|#|#|#|#|#|#|#|#|#|#|#|#|#|#|#|
|#|#|#|#|#|#|#|#|#|#|#|#|#|#|#|#|
|#|#|#|#|#|#|#|#|#|#|#|#|#|#|#|#|
|#|#|#|#|#|#|#|#|#|#|#|#|#|#|#|#|
---------------------------------

Gameover :(
